#########################################
#       #     #     #       #     #     #
####### # ### ### # ### ### ### # ### # #
#       # #       # #   # #     #   # #.#
# ### ### # ####### # ### ######### # ###
# # # #   #   #   # #   #   #     # #   #
# # # # ####### # # ### ### # # # # ### #
# # # #         # #   #   #   # # #   # #
# # # ########### ### ### # ### ##### # #
# #     #       #   #   # # #   #     # #
# ##### ##### ##### ### # ### # # ##### #
#     #       #   # #   # #   # # #   # #
# ### ##### ### # # # ### # ### # # # # #
#   #   #   #   #   # #   # #   # # # # #
##### # # ### ####### # ### # ### # # # #
#   # # # #   #     #   #   #   # # #   #
# # ### # # ### ### ##### ##### # # ### #
# #     # #     # #   #     # # # #   # #
# ####### ####### ### # ### # # # ### ###
#       # #         # # #   #   #   #   #
# ##### # # ### ### # # # ### ##### ### #
# # #   # # # #   # #o# # #       #   # #
# # # ##### # ### ####### ####### ### # #
# # #     # #   #         #   #   # # # #
# # ##### # # # ### ####### # # ### # # #
#     #   # # #   #         # #   # # # #
### ### ### # ### ########### ### # # # #
# # #   #   # #         #     #     #   #
# # # ### ##### ####### # ##### ####### #
#   #   # #   #       # # #     #       #
####### # # # ####### ### ### ### #######
#     # # # #       #   #   # #   #     #
# ### # # # ####### ### ### # # ### #####
# # # # # #       #     #   # #   #     #
# # # # # # ##### ##### # ####### ##### #
# #   # # #   #   #     #   #     #     #
# # ### # ### # ########### # ##### ### #
# #     #   # #           # # #     #   #
# ######### ########### # # # ### ### ###
#                       # #       #     #
#########################################
